%.............*
%.............*
%###.......###*
%.............*
%.....###.....*
%.............*
%...#.....#...*
%......@......*
###############
###############