..............
..............
###.......####
..............
.....###......
..............
...#.....#....
...@..........
##############
##############